########
#+ %   #
#     @#
#### %+#
#+ %   #
########